00,00,00,00,00,00,00,00,00,00,00,00,00,00,00,00,00,00,00,00
00,10,06,07,08,06,06,07,06,06,06,06,08,06,06,06,06,06,11,00
00,10,01,01,01,01,01,01,01,01,01,01,01,01,01,01,01,01,11,00
00,10,01,01,01,01,05,01,01,01,01,01,01,01,01,01,01,01,11,00
00,10,01,03,01,01,01,02,04,01,01,01,01,01,01,01,01,01,11,00
00,10,02,01,01,01,01,01,01,01,03,01,01,01,01,01,01,01,11,00
00,10,01,01,01,01,01,01,01,01,01,01,01,01,01,01,01,01,11,00
00,10,01,01,01,01,01,01,01,01,01,04,01,01,01,01,01,01,11,00
00,10,01,01,01,01,01,01,01,01,01,01,01,01,01,01,01,01,11,00
00,10,01,01,05,01,01,01,01,01,01,01,01,01,01,01,01,05,11,00
00,10,01,01,01,01,01,01,01,01,01,01,01,01,01,01,01,01,11,00
00,10,01,03,01,01,01,01,01,01,01,01,01,01,02,01,01,01,11,00
00,10,01,01,01,01,01,01,01,01,01,01,01,01,01,01,01,01,11,00
00,10,01,01,01,01,01,01,01,01,01,01,01,01,05,01,01,01,11,00
00,10,01,01,01,02,01,01,01,01,01,01,02,01,01,01,01,01,11,00
00,10,01,01,01,03,01,01,01,01,01,01,01,01,01,01,01,01,11,00
00,10,01,01,01,01,01,01,01,01,01,01,01,01,01,05,01,01,11,00
00,10,01,01,01,01,01,01,01,04,01,01,04,01,01,01,01,01,11,00
00,13,12,12,12,12,12,12,12,12,12,12,12,12,12,12,12,12,14,00
00,00,00,00,00,00,00,00,00,00,00,00,00,00,00,00,00,00,00,00

0,0,0,0,0,0,0,0,0,0,0,0,0,0,0,0,0,0,0,0
0,0,1,1,1,1,1,1,1,1,1,1,1,1,1,1,1,1,0,0
0,1,0,0,0,0,0,0,0,0,0,0,0,0,0,0,0,0,1,0
0,1,0,0,0,0,0,0,0,0,0,0,0,0,0,0,0,0,1,0
0,1,0,0,0,0,0,0,0,0,0,0,0,0,0,0,0,0,1,0
0,1,0,0,0,0,0,0,0,0,0,0,0,0,0,0,0,0,1,0
0,1,0,0,0,0,0,0,0,0,0,0,0,0,0,0,0,0,1,0
0,1,0,0,0,0,0,0,0,0,0,0,0,0,0,0,0,0,1,0
0,1,0,0,0,0,0,0,0,0,0,0,0,0,0,0,0,0,1,0
0,1,0,0,0,0,0,0,0,0,0,0,0,0,0,0,0,0,1,0
0,1,0,0,0,0,0,0,0,0,0,0,0,0,0,0,0,0,1,0
0,1,0,0,0,0,0,0,0,0,0,0,0,0,0,0,0,0,1,0
0,1,0,0,0,0,0,0,0,0,0,0,0,0,0,0,0,0,1,0
0,1,0,0,0,0,0,0,0,0,0,0,0,0,0,0,0,0,1,0
0,1,0,0,0,0,0,0,0,0,0,0,0,0,0,0,0,0,1,0
0,1,0,0,0,0,0,0,0,0,0,0,0,0,0,0,0,0,1,0
0,1,0,0,0,0,0,0,0,0,0,0,0,0,0,0,0,0,1,0
0,1,0,0,0,0,0,0,0,0,0,0,0,0,0,0,0,0,1,0
0,0,1,1,1,1,1,1,1,1,1,1,1,1,1,1,1,1,0,0
0,0,0,0,0,0,0,0,0,0,0,0,0,0,0,0,0,0,0,0